#########################
#00000000000000000000000#
#00000000000000000000000#
#00000000000000000000000#
#00000000000000000000000#
#110000000p000010000rr00#
#1000011111111111000rr00#
#0000011111111111000rr00#
#########################