##########################################################################################################################
#rrrrrrrrrrrrrrrrrrrrrrrrrrrrrrrrrrrrrrrrrrrrrrrrrrrrrrrrrrrrrrrrrrrrrrrrrrrrrrrrrrrrrrrrrrrrrrrrrrrrrrrrrrrrrrrrrrrrrrrr#
#rrr00000000000000000000000000000000000000000000000000000000000000000000000000000000000000000000000000000000000000000000r#
#r0000000000000000000000000000000000000000000000000000000000000000000000000000000000000000000000000000000000000000000000r#
#r000000000000000000000000000000000rrrrrrrrrrrrrrrrrrrrrrrrrrrrrrr000000000000000000000000000a00000000000000000000000000r#
#r100000000000000000rrr000000000000rrrrrrrrrrrrrrrrrrrrrrrrrrrrrrr00c000c0c000000000111111111110000000000000000000000000r#
#r000011111111111000rrr0000000000000000000000000000000000000000000000000000000011111111111111110000000000000000000000000r#
#r000011111111111000rrr0111100000000000000000000000000000000000000000000000011111111111000000000000000000000000000000000r#
#r0000000000000000000000111100001111111111100000000000000000000000000000000011100000000000000000000000000000000000000000r#
#r0000000000000000000000000000001111111111100000000000000000000000000000000000000000000000000000000000000000000000000000r#
#r0000000000000000000000000000000000000000000000000000000000000000000000000000000000000000000000000000000000000000000000r#
#r0000000000000000000000000000000000000000000001111111000000000000000000000000000000000000000000000000000000000000000000r#
#r0000000000000000000000000000000000000000000001111111000000000000000000000000000000000000000000000000000000000000000000r#
#r0000000000000000000000111000001111111111111100000000000000000000000000000000000000000000000000000000000000000000000000r#
#r0000000000000000000000111000001111111111111100000000000000000000000000000000000000000000000000000000000000000000000000r#
#r0000000000000000000000000000000000000000000000000000000000000000000000000000000000000000000000000000000000000000000000r#
#r0000000000000000000000000011100000000000000000000000000000000000000000000000000000000000000000000000000000000000000000r#
#r0000000000000000000000000011100000000000000000000000000000000000000000000000000000000000000000000000000000000000000000r#
#r0000000000000000000000000000000000000000000000000000000000000000000000000000000000000000000000000000000000000000000000r#
#r0000000000000000000011111000000000000000000000000000000000000000000000000000000000000000000000000000000000000000000000r#
#r0000000000000000000011111000000000000000000000000000000000000000000000000000000000000000000000000000000000000000000000r#
#r00000000000000rrr00000000000000000000000000000000000000000000000000000000000000000000000000000000000000000000000000000r#
#r00000000000000rrr00000000000000000000000000000000000000000000000000000000000000000000000000000000000000000000000000000r#
#r00000000000000rrr11000000rrr000000000000000000000000000000000000000000000000000000000000000000000000000000000000000000r#
#r00000000000000rrr11000000rrr000000000000000000000000000000000000000000000000000000000000000000000000000000000000000000r#
#r00000000000000rrr00000011rrr000000000000000000000000000000000000000000000000000000000000000000000000000000000000000000r#
#r0000000000000000000000011rrr000000000000000000000000000000000000000000000000000000000000000000000000000000000000000000r#
#r0000000000000000000000000rrr000000000000000000000000000000000000000000000000000000000000000000000000000000000000000000r#
#r000000000000000000rrr0000rrr000000000011111111111100000000000000000000000000000000000000000000000000000000000000000000r#
#r000000000000000000rrr0000000000000000011111111111100000111111111111111111100000000000000000000000000000000000000000000r#
#r111000000000000000rrr0000000000000000011111111111100000111111111111111111100000000000rrrrr0000000000000000000000000000r#
#r111111111100011000rrr1111110000000000000000000000000000000000000000000000000000000000rrrrr0000000000000000000000000000r#
#r11111111110001100011111111110000000000000000000000000000000000c0000000000000000000000000000000000000000000000000000000r#
#r11111111110001100011111111111110000000110000000rrr000000000000000000000000000000rrrr0000000000000000000000000000000000r#
#r00000000000000000000000001111110000000111111110rrr000000p00000000000000000000000rrrr0000000000000000000000000000000000r#
#r00000000000000000000000000000000000000111111110111000011111111111100111111111100000000rrrr0000000000000000000000000000r#
#r00000000000000000000000000000000000111111111110111000011111111111100111111111100000000rrrr0000000000000000000000000000r#
#r00000000000000000000000000000000111111110000000000000000000000000000000000000000rrrrr000000000000000000000000000000000r#
#r00000000000000000000000000000000111100000000000000111100000000000000000000000000rrrrr000000000000000000000000000000000r#
#r00000000000000000000000000001111111000000000000000111100111111000000000000000000rrrrr000000000000000000000000000000000r#
#r0000000000000000000000000rrr111011100000000000000011111111111100000000000000000000000000000000000000000000000000000000r#
#r0000000000000000000000000rrrrrrr11100000000000000000001100000000000000000000000000000000000000000000000000000000000000r#
#r0000000000000000000000000000000011100000000000000000000000000000000000000000000000000000000000000000000000000000000000r#
#r000rrrrrrrrrrrrrrrrrrrr00000000011100000000000000000000000000000000000000000000000000000000000000000000000000000000000r#
#r000rrrrrrrrrrrrrrrrrrrr00000000000000000000000000000000000000000000000000000000000000000000000000000000000000000000000r#
#r000rrrrrrrrrrrrrrrrrrrr00111100000000000000000000000000000000000000000000000000000000000000000000000000000000000000000r#
#r0000000000000000000000000111100000000000000000000000000000000000000000000000000000000000000000000000000000000000000000r#
#r000000000000000000000000000000001110000rrr000rrr0000000000000000000000000000000000000000000000000000000000000000000000r#
#r000000000000000000000000000000001110000rrr111rrr0000000000000000000000000000000000000000000000000000000000000000000000r#
#r000000000000000000000000000000001110000rrr111rrr0000111111110000000000000000000000000000000000000000000000000000000000r#
#r000000000000000000000000000000001110000rrr111rrr0000111111110000000000000000000000000000000000000000000000000000000000r#
#r000000000000000000000000000000001110000rrrrrrrrr0000111111110000000rrrrrrrr0000000000000000000000000000000000000000000r#
#r000000000rrrrr00000000000000000011100000000000000000000000000000000rrrrrrrr0000000000000000000000000000000000000000000r#
#r011100000rrrrr0000000000000000000000000000000000000000000000000000rr00000000000000000000000000000000000000000000000000r#
#r0111000000000000000000000000000000000000000000000000000000000000rrrrrrrrrrr0000000000000000000000000000000000000000000r#
#r0111110000000000000000000000000000000000000000000000000111110000rrrrrrrrrrr0000000000000000000000000000000000000000000r#
#r011111000000000000000000rrrrrrrrrrr00000000000000000000111110000000000000000000000000000000000000000000000000000000000r#
#r000000000001111111111000rrrrrrrrrrrrr000000000000000000000000000000000000000000000000000000000000000000000000000000000r#
#r00000000000111111111100000000000rrrrr000011111111111110000000000000000000000000000000000000000000000000000000000000000r#
#r0000000000000000000000000000000011100001111111111111110000000000000000000000000000000000000000000000000000000000000000r#
#r00rr000000rrrrr0000000000000000011100001111111111111110000000000000000000000000000000000000000000000000000000000000000r#
#r00rr0000rrrrrrr0000000000000000011100000000000000000000000000000000000000000000000000000000000000000000000000000000000r#
#r00000000rrrrrrr0000000000000000011100000000000000000000000000000000000000000000000000000000000000000000000000000000000r#
#r0000000000rrrrr0000000000000000011100000000000000000000000000000000000000000000000000000000000000000000000000000000000r#
#rrrrrr00000000000000000000000000011100000000000000000000000000000000000000000000000000000000000000000000000000000000000r#
#rrrrrr00000000000000000000000000011100000000000000000000000000000000000000000000000000000000000000000000000000000000000r#
#r0000000000rrrr00000000000000000000000000000000000000000000000000000000000000000000000000000000000000000000000000000000r#
#r0000000000rrrr00000000000000000000000000000000000000000000000000000000000000000000000000000000000000000000000000000000r#
#rrrrrrrrrrrrrrrrrrrrrrrrrrrrrrrrrrrrrrrrrrrrrrrrrrrrrrrrrrrrrrrrrrrrrrrrrrrrrrrrrrrrrrrrrrrrrrrrrrrrrrrrrrrrrrrrrrrrrrrr#
##########################################################################################################################