#########################
#00000000000000000000000#
#00000000000000000000000#
#00000000000000000000000#
#00000000000000000000000#
#110000000p0000000001100#
#10000111111111110001100#
#00000111111111110001100#
#########################